1 1 1 1 1 1 1 1 1 1 1 1 1 1 1 1
1 2 2 2 2 2 2 2 2 2 2 2 2 2 2 1
1 2 9 6 6 6 6 6 6 6 6 6 6 10 2 1
1 2 3 0 0 0 0 0 0 0 0 0 0 4 2 1
1 2 3 0 0 0 0 0 0 0 0 0 0 4 2 1
1 2 3 0 0 0 0 0 0 0 0 0 0 4 2 1
1 2 3 0 0 0 0 0 0 0 0 0 0 4 2 1
1 2 3 0 0 0 0 0 0 0 0 0 0 4 2 1
1 2 0 0 0 0 0 0 0 0 0 0 0 4 2 1
1 2 7 5 5 5 5 5 5 5 5 5 5 8 2 1
1 2 2 2 2 2 2 2 2 2 2 2 2 2 2 1
1 1 1 1 1 1 1 1 1 1 1 1 1 1 1 1